//MAP CONVERTED BY dmm2tgm.py THIS HEADER COMMENT PREVENTS RECONVERSION, DO NOT REMOVE
"aj" = (
/obj/structure/table/glass,
/obj/item/chems/dropper,
/obj/item/stack/nanopaste,
/obj/effect/floor_decal/corner/blue/mono,
/obj/machinery/light/small{
	dir = 4
	},
/turf/simulated/floor/tiled/white/monotile)
"bU" = (
/obj/machinery/light{
	dir = 8
	},
/turf/simulated/floor/tiled/steel_ridged)
"cb" = (
/obj/effect/floor_decal/corner/mauve{
	dir = 5
	},
/turf/simulated/floor/tiled/white)
"cH" = (
/obj/machinery/optable,
/obj/effect/floor_decal/corner/blue/mono,
/turf/simulated/floor/tiled/white/monotile)
"dh" = (
/obj/machinery/design_database,
/obj/effect/floor_decal/corner/mauve/mono,
/turf/simulated/floor/tiled/white/monotile)
"dz" = (
/obj/machinery/atmospherics/pipe/simple/hidden{
	dir = 5
	},
/turf/simulated/floor)
"es" = (
/obj/machinery/light,
/turf/simulated/open)
"fJ" = (
/obj/machinery/light/small{
	dir = 1
	},
/obj/machinery/atmospherics/unary/vent_pump/high_volume/external_air{
	id_tag = "upper_level_dock_pump"
	},
/turf/simulated/floor)
"fS" = (
/obj/effect/floor_decal/industrial/warning/dust{
	dir = 4
	},
/obj/effect/floor_decal/corner/orange{
	dir = 9
	},
/turf/simulated/floor/tiled/steel_grid)
"fU" = (
/obj/effect/floor_decal/industrial/warning/dust,
/turf/simulated/floor)
"fX" = (
/obj/machinery/alarm{
	pixel_y = 24
	},
/turf/simulated/floor/tiled/steel_grid)
"gl" = (
/obj/machinery/atmospherics/pipe/simple/hidden{
	dir = 5
	},
/turf/simulated/floor/tiled/white)
"gs" = (
/obj/machinery/atmospherics/pipe/manifold/hidden{
	dir = 1
	},
/obj/structure/railing/mapped{
	dir = 1
	},
/turf/simulated/floor/tiled/white)
"hM" = (
/obj/machinery/light{
	dir = 8
	},
/turf/simulated/floor)
"ii" = (
/obj/machinery/door/airlock/external/bolted{
	id_tag = "upper_level_dock_hatch_internal"
	},
/turf/simulated/floor)
"iS" = (
/obj/machinery/atmospherics/pipe/simple/hidden{
	dir = 4
	},
/obj/machinery/alarm{
	dir = 1;
	pixel_y = -19
	},
/turf/simulated/floor/tiled/white)
"iY" = (
/obj/machinery/atmospherics/pipe/manifold/hidden,
/obj/structure/railing/mapped,
/turf/simulated/floor/tiled/white)
"jd" = (
/obj/machinery/atmospherics/pipe/simple/hidden{
	dir = 9
	},
/turf/simulated/floor/tiled/steel_grid)
"jr" = (
/obj/effect/floor_decal/industrial/warning/dust/corner{
	dir = 8
	},
/obj/effect/floor_decal/corner/orange{
	dir = 5
	},
/turf/simulated/floor/tiled/steel_grid)
"jW" = (
/obj/effect/floor_decal/industrial/warning{
	dir = 4
	},
/turf/simulated/floor/tiled/dark/monotile)
"kf" = (
/obj/machinery/fabricator/robotics,
/obj/effect/floor_decal/corner/mauve/mono,
/turf/simulated/floor/tiled/white/monotile)
"kx" = (
/obj/machinery/door/airlock/external/bolted{
	id_tag = "upper_level_dock_hatch_external"
	},
/obj/machinery/button/access/exterior{
	id_tag = "upper_level_dock";
	pixel_y = -21
	},
/turf/simulated/floor)
"lm" = (
/obj/machinery/atmospherics/pipe/simple/hidden{
	dir = 4
	},
/turf/simulated/floor/tiled/white)
"ln" = (
/obj/effect/floor_decal/industrial/warning/dust/corner,
/obj/effect/floor_decal/corner/orange/three_quarters{
	dir = 8
	},
/turf/simulated/floor/tiled/steel_grid)
"lJ" = (
/turf/simulated/floor)
"lP" = (
/turf/simulated/floor/tiled/white)
"mC" = (
/obj/effect/floor_decal/corner/orange,
/turf/simulated/floor/tiled/steel_grid)
"nz" = (
/obj/machinery/light{
	dir = 1
	},
/turf/simulated/floor/tiled/steel_grid)
"nC" = (
/obj/effect/floor_decal/corner/mauve/mono,
/obj/effect/floor_decal/industrial/outline/yellow,
/obj/machinery/light/small{
	dir = 4
	},
/turf/simulated/floor/tiled/white/monotile)
"nO" = (
/obj/machinery/atmospherics/unary/vent_pump/on,
/turf/simulated/floor/tiled/white)
"oi" = (
/obj/structure/tank_rack/oxygen,
/obj/machinery/light,
/turf/simulated/floor/tiled/dark/monotile)
"oC" = (
/obj/machinery/suit_cycler/engineering/prepared,
/turf/simulated/floor/tiled/dark/monotile)
"oI" = (
/obj/machinery/light,
/turf/simulated/floor/tiled/steel_grid)
"oS" = (
/turf/simulated/open,
/area/space)
"pc" = (
/obj/effect/wallframe_spawn/reinforced,
/turf/simulated/floor/plating)
"pk" = (
/obj/machinery/light{
	dir = 1
	},
/turf/simulated/floor)
"pr" = (
/obj/machinery/computer/operating{
	dir = 1
	},
/obj/effect/floor_decal/corner/blue/mono,
/turf/simulated/floor/tiled/white/monotile)
"ps" = (
/obj/machinery/atmospherics/unary/vent_pump/high_volume/external_air{
	id_tag = "upper_level_dock_pump"
	},
/obj/machinery/airlock_sensor{
	id_tag = "upper_level_dock_sensor_chamber";
	pixel_x = 24
	},
/obj/machinery/embedded_controller/radio/airlock/docking_port{
	id_tag = "upper_level_dock";
	pixel_y = 24;
	tag_airpump = "upper_level_dock_pump";
	tag_chamber_sensor = "upper_level_dock_sensor_chamber";
	tag_exterior_door = "upper_level_dock_hatch_external";
	tag_interior_door = "upper_level_dock_hatch_internal"
	},
/turf/simulated/floor)
"pt" = (
/obj/effect/floor_decal/industrial/warning/dust/corner{
	dir = 4
	},
/obj/effect/floor_decal/corner/orange/three_quarters,
/turf/simulated/floor/tiled/steel_grid)
"qk" = (
/obj/structure/railing/mapped{
	dir = 8
	},
/turf/simulated/floor/tiled/white)
"qA" = (
/obj/effect/floor_decal/industrial/warning/dust,
/obj/effect/floor_decal/corner/orange{
	dir = 5
	},
/turf/simulated/floor/tiled/steel_grid)
"qV" = (
/obj/machinery/light{
	dir = 8
	},
/turf/simulated/floor/tiled/steel_grid)
"qW" = (
/obj/machinery/atmospherics/portables_connector,
/obj/machinery/portable_atmospherics/canister/air,
/obj/effect/floor_decal/industrial/outline/blue,
/obj/machinery/light{
	dir = 4
	},
/turf/simulated/floor/tiled/dark/monotile)
"rb" = (
/obj/effect/floor_decal/corner/blue/mono,
/obj/machinery/sleeper/standard,
/turf/simulated/floor/tiled/white/monotile)
"rn" = (
/obj/machinery/door/airlock,
/turf/simulated/floor/tiled/steel_ridged)
"sA" = (
/turf/simulated/floor/tiled/steel_ridged)
"sO" = (
/obj/machinery/door/airlock/external/bolted{
	id_tag = "upper_level_dock_hatch_internal"
	},
/obj/machinery/atmospherics/pipe/simple/hidden,
/turf/simulated/floor)
"sT" = (
/obj/effect/floor_decal/corner/mauve{
	dir = 5
	},
/obj/machinery/atmospherics/pipe/simple/hidden{
	dir = 6
	},
/turf/simulated/floor/tiled/white)
"sV" = (
/obj/machinery/atmospherics/pipe/simple/hidden,
/obj/machinery/button/access/interior{
	id_tag = "upper_level_dock";
	pixel_x = 22;
	pixel_y = 28
	},
/turf/simulated/floor/tiled/steel_grid)
"sY" = (
/obj/effect/floor_decal/industrial/warning/dust{
	dir = 4
	},
/obj/effect/floor_decal/corner/orange{
	dir = 9
	},
/obj/machinery/light/small{
	dir = 8
	},
/turf/simulated/floor/tiled/steel_grid)
"ug" = (
/obj/abstract/level_data_spawner/main_level{
	name = "Ship Second Deck"
	},
/turf/simulated/open,
/area/space)
"uk" = (
/obj/effect/floor_decal/industrial/warning/dust{
	dir = 8
	},
/obj/machinery/atmospherics/pipe/simple/hidden{
	dir = 4
	},
/turf/simulated/floor/tiled/steel_grid)
"un" = (
/obj/machinery/light{
	dir = 4
	},
/turf/simulated/floor)
"uF" = (
/obj/effect/floor_decal/industrial/warning/dust{
	dir = 8
	},
/turf/simulated/floor/tiled/steel_grid)
"wP" = (
/turf/simulated/open)
"xk" = (
/obj/machinery/light{
	dir = 4
	},
/turf/simulated/open)
"xD" = (
/obj/effect/floor_decal/corner/orange{
	dir = 10
	},
/turf/simulated/floor/tiled/steel_grid)
"xX" = (
/obj/machinery/light{
	dir = 4
	},
/turf/simulated/floor/tiled/steel_grid)
"ys" = (
/obj/structure/table/glass,
/obj/item/storage/box/syringes,
/obj/item/storage/box/freezer,
/obj/effect/floor_decal/corner/blue/mono,
/turf/simulated/floor/tiled/white/monotile)
"yy" = (
/obj/structure/railing/mapped{
	dir = 4
	},
/turf/simulated/floor/tiled/white)
"yE" = (
/turf/simulated/floor/tiled/dark/monotile)
"zG" = (
/obj/effect/floor_decal/industrial/warning/dust/corner{
	dir = 1
	},
/obj/effect/floor_decal/corner/orange{
	dir = 10
	},
/turf/simulated/floor/tiled/steel_grid)
"Am" = (
/obj/machinery/light,
/turf/simulated/floor)
"Ba" = (
/obj/effect/floor_decal/corner/orange{
	dir = 9
	},
/obj/machinery/light{
	dir = 8
	},
/turf/simulated/floor/tiled/steel_grid)
"BG" = (
/obj/machinery/light/small{
	dir = 8
	},
/turf/simulated/floor/tiled/white)
"BY" = (
/obj/effect/floor_decal/industrial/warning/dust{
	dir = 1
	},
/obj/effect/floor_decal/corner/orange{
	dir = 10
	},
/turf/simulated/floor/tiled/steel_grid)
"Ci" = (
/obj/machinery/power/debug_items/infinite_generator,
/obj/structure/cable/yellow,
/turf/simulated/floor/tiled/white)
"Cq" = (
/obj/machinery/light_switch/on{
	dir = 1;
	pixel_y = -20
	},
/turf/simulated/floor/tiled/white)
"Cu" = (
/obj/effect/floor_decal/corner/orange{
	dir = 6
	},
/turf/simulated/floor/tiled/steel_grid)
"CN" = (
/obj/effect/floor_decal/corner/mauve{
	dir = 5
	},
/obj/machinery/atmospherics/pipe/simple/hidden{
	dir = 4
	},
/turf/simulated/floor/tiled/white)
"CW" = (
/turf/simulated/floor/tiled/steel_grid)
"CX" = (
/obj/structure/cable/yellow{
	icon_state = "1-2"
	},
/turf/simulated/floor/tiled/white)
"Dt" = (
/obj/effect/floor_decal/corner/blue/mono,
/obj/structure/closet/secure_closet/freezer/meat,
/turf/simulated/floor/tiled/white/monotile)
"En" = (
/obj/machinery/bodyscanner{
	dir = 1
	},
/obj/effect/floor_decal/corner/blue/mono,
/turf/simulated/floor/tiled/white/monotile)
"EO" = (
/obj/machinery/fabricator/protolathe,
/obj/effect/floor_decal/corner/mauve/mono,
/turf/simulated/floor/tiled/white/monotile)
"FE" = (
/obj/effect/floor_decal/corner/orange{
	dir = 10
	},
/obj/effect/floor_decal/industrial/warning{
	dir = 4
	},
/turf/simulated/floor/tiled/steel_grid)
"Gn" = (
/obj/effect/wallframe_spawn/reinforced,
/turf/simulated/floor)
"Gy" = (
/obj/effect/floor_decal/corner/orange/three_quarters{
	dir = 8
	},
/turf/simulated/floor/tiled/steel_grid)
"GG" = (
/obj/structure/railing/mapped,
/turf/simulated/open)
"GP" = (
/obj/machinery/light{
	dir = 4
	},
/obj/machinery/atmospherics/portables_connector{
	dir = 1
	},
/obj/machinery/portable_atmospherics/canister/empty,
/obj/effect/floor_decal/industrial/outline/red,
/turf/simulated/floor/tiled/dark/monotile)
"Hn" = (
/obj/structure/table/glass,
/obj/item/storage/box/gloves,
/obj/item/storage/box/masks,
/obj/effect/floor_decal/corner/blue/mono,
/turf/simulated/floor/tiled/white/monotile)
"Hp" = (
/obj/structure/grille,
/turf/space,
/area/space)
"JU" = (
/obj/structure/table/glass,
/obj/item/scalpel/laser,
/obj/item/scalpel/laser/upgraded,
/obj/item/scalpel/laser/advanced,
/obj/item/robotanalyzer,
/obj/item/scanner/health,
/obj/item/storage/firstaid/adv,
/obj/effect/floor_decal/corner/blue/mono,
/turf/simulated/floor/tiled/white/monotile)
"Lq" = (
/obj/structure/stairs{
	dir = 1
	},
/turf/simulated/floor/tiled/white)
"Lz" = (
/obj/machinery/atmospherics/unary/vent_scrubber/on{
	dir = 1
	},
/turf/simulated/floor/tiled/white)
"LK" = (
/obj/structure/table/glass,
/obj/item/storage/firstaid/surgery,
/obj/effect/floor_decal/corner/blue/mono,
/turf/simulated/floor/tiled/white/monotile)
"LX" = (
/obj/machinery/fabricator/imprinter,
/obj/effect/floor_decal/corner/mauve/mono,
/turf/simulated/floor/tiled/white/monotile)
"Nj" = (
/obj/effect/floor_decal/industrial/warning/dust{
	dir = 1
	},
/obj/effect/floor_decal/corner/orange{
	dir = 10
	},
/obj/machinery/light/small,
/turf/simulated/floor/tiled/steel_grid)
"Ny" = (
/obj/machinery/atmospherics/pipe/manifold/hidden{
	dir = 4
	},
/turf/simulated/floor)
"NY" = (
/obj/structure/ladder,
/turf/simulated/open)
"Pc" = (
/obj/effect/floor_decal/corner/orange{
	dir = 5
	},
/turf/simulated/floor/tiled/steel_grid)
"Qn" = (
/obj/machinery/destructive_analyzer,
/obj/effect/floor_decal/corner/mauve/mono,
/turf/simulated/floor/tiled/white/monotile)
"QJ" = (
/obj/effect/floor_decal/corner/orange{
	dir = 6
	},
/obj/machinery/light{
	dir = 4
	},
/turf/simulated/floor/tiled/steel_grid)
"QU" = (
/obj/structure/rack,
/obj/item/stack/material/reinforced/mapped/plasteel/fifty,
/obj/item/stack/material/ingot/mapped/copper/fifty,
/obj/item/stack/material/sheet/mapped/steel/fifty,
/obj/item/stack/material/pane/mapped/glass/fifty,
/obj/item/stack/material/reinforced/mapped/fiberglass/fifty,
/obj/item/stack/material/ingot/mapped/gold/ten,
/obj/item/stack/material/segment/mapped/mhydrogen/ten,
/obj/item/stack/material/ingot/mapped/silver/ten,
/obj/item/stack/material/puck/mapped/uranium/ten,
/obj/item/stack/material/gemstone/mapped/diamond/ten,
/obj/item/storage/belt/utility/full,
/obj/item/stack/material/sheet/mapped/steel/fifty,
/obj/effect/floor_decal/corner/blue/mono,
/turf/simulated/floor/tiled/white/monotile)
"SQ" = (
/obj/machinery/atmospherics/pipe/simple/hidden{
	dir = 10
	},
/turf/simulated/floor/tiled/steel_grid)
"Uf" = (
/obj/effect/floor_decal/corner/orange/three_quarters{
	dir = 4
	},
/turf/simulated/floor/tiled/steel_grid)
"UN" = (
/obj/machinery/computer/design_console{
	dir = 1
	},
/obj/effect/floor_decal/corner/mauve/mono,
/turf/simulated/floor/tiled/white/monotile)
"Vm" = (
/obj/effect/floor_decal/industrial/warning/dust{
	dir = 4
	},
/turf/simulated/floor)
"VG" = (
/obj/machinery/fabricator/bioprinter,
/obj/effect/floor_decal/corner/blue/mono,
/turf/simulated/floor/tiled/white/monotile)
"Xm" = (
/obj/structure/iv_drip,
/obj/item/chems/ivbag/blood/ominus,
/obj/item/chems/ivbag/blood/ominus,
/obj/item/chems/ivbag/blood/ominus,
/obj/effect/floor_decal/corner/blue/mono,
/turf/simulated/floor/tiled/white/monotile)
"Xw" = (
/obj/machinery/light/small{
	dir = 4
	},
/turf/simulated/open)
"XE" = (
/turf/simulated/wall/r_wall/prepainted)
"XR" = (
/obj/effect/floor_decal/corner/orange{
	dir = 9
	},
/turf/simulated/floor/tiled/steel_grid)
"Yn" = (
/obj/machinery/fabricator/industrial,
/obj/effect/floor_decal/corner/mauve/mono,
/turf/simulated/floor/tiled/white/monotile)
"Yy" = (
/turf/simulated/floor/shuttle_ceiling,
/area/space)
"YT" = (
/obj/effect/floor_decal/corner/mauve{
	dir = 1
	},
/obj/machinery/atmospherics/pipe/simple/hidden{
	dir = 4
	},
/obj/machinery/power/apc{
	dir = 1;
	pixel_y = 21
	},
/obj/structure/cable/yellow{
	icon_state = "0-2"
	},
/turf/simulated/floor/tiled/white)
"ZD" = (
/obj/machinery/body_scanconsole{
	dir = 1
	},
/obj/effect/floor_decal/corner/blue/mono,
/turf/simulated/floor/tiled/white/monotile)
"ZI" = (
/obj/machinery/atmospherics/portables_connector{
	dir = 1
	},
/obj/machinery/portable_atmospherics/canister/air/airlock,
/turf/simulated/floor/tiled/dark/monotile)

(1,1,1) = {"
oS
oS
oS
oS
oS
oS
oS
oS
oS
oS
oS
oS
oS
oS
oS
oS
oS
oS
oS
oS
oS
oS
oS
oS
oS
oS
oS
oS
oS
oS
oS
oS
oS
oS
oS
oS
oS
oS
oS
oS
oS
oS
oS
oS
oS
oS
oS
oS
oS
oS
oS
ug
"}
(2,1,1) = {"
oS
oS
oS
oS
oS
oS
oS
oS
oS
oS
oS
oS
oS
oS
oS
oS
oS
oS
oS
oS
oS
oS
oS
oS
oS
oS
oS
oS
oS
oS
oS
oS
oS
oS
oS
oS
oS
oS
oS
oS
oS
oS
oS
oS
oS
oS
oS
oS
oS
oS
oS
oS
"}
(3,1,1) = {"
oS
oS
oS
oS
oS
oS
oS
oS
oS
oS
oS
oS
oS
oS
oS
oS
oS
oS
oS
oS
oS
oS
oS
oS
oS
oS
oS
oS
oS
oS
oS
oS
oS
oS
oS
oS
oS
oS
oS
oS
oS
oS
oS
oS
oS
oS
oS
oS
oS
oS
oS
oS
"}
(4,1,1) = {"
oS
oS
oS
oS
oS
oS
oS
oS
oS
oS
oS
oS
oS
oS
oS
oS
oS
oS
oS
oS
oS
oS
oS
oS
oS
oS
oS
oS
oS
oS
oS
oS
oS
oS
oS
oS
oS
oS
oS
oS
oS
oS
oS
oS
oS
oS
oS
oS
oS
oS
oS
oS
"}
(5,1,1) = {"
oS
oS
oS
oS
oS
oS
oS
oS
oS
oS
oS
oS
oS
oS
oS
oS
oS
oS
oS
oS
oS
oS
oS
oS
oS
oS
oS
oS
oS
oS
oS
oS
oS
oS
oS
oS
oS
oS
oS
oS
oS
oS
oS
oS
oS
oS
oS
oS
oS
oS
oS
oS
"}
(6,1,1) = {"
oS
oS
oS
oS
oS
oS
oS
oS
oS
oS
oS
oS
oS
oS
oS
oS
oS
oS
oS
oS
oS
oS
oS
oS
oS
oS
oS
oS
oS
oS
oS
oS
oS
oS
oS
oS
oS
oS
oS
oS
oS
oS
oS
oS
oS
oS
oS
oS
oS
oS
oS
oS
"}
(7,1,1) = {"
oS
oS
oS
oS
oS
oS
oS
oS
oS
oS
oS
oS
oS
oS
oS
oS
oS
oS
oS
oS
oS
oS
oS
oS
oS
oS
oS
oS
oS
oS
oS
oS
oS
oS
oS
oS
oS
oS
oS
oS
oS
oS
oS
oS
oS
oS
oS
oS
oS
oS
oS
oS
"}
(8,1,1) = {"
oS
oS
oS
oS
oS
oS
oS
oS
oS
oS
oS
oS
oS
oS
oS
oS
oS
oS
oS
oS
oS
oS
oS
oS
oS
oS
oS
oS
oS
oS
oS
oS
oS
oS
oS
oS
oS
oS
oS
oS
oS
oS
oS
oS
oS
oS
oS
oS
oS
oS
oS
oS
"}
(9,1,1) = {"
oS
oS
oS
oS
oS
oS
oS
oS
oS
oS
oS
oS
oS
oS
oS
oS
oS
oS
oS
oS
oS
oS
oS
oS
oS
oS
oS
oS
oS
oS
oS
oS
oS
oS
oS
oS
oS
oS
oS
oS
oS
oS
oS
oS
oS
oS
oS
oS
oS
oS
oS
oS
"}
(10,1,1) = {"
oS
oS
oS
oS
oS
oS
oS
oS
oS
oS
oS
oS
oS
oS
oS
oS
oS
oS
oS
oS
oS
oS
oS
oS
oS
oS
oS
oS
oS
oS
oS
oS
oS
oS
oS
oS
oS
oS
oS
oS
oS
oS
oS
oS
oS
oS
oS
oS
oS
oS
oS
oS
"}
(11,1,1) = {"
oS
oS
oS
oS
oS
oS
oS
oS
oS
oS
XE
XE
XE
XE
XE
XE
XE
XE
XE
XE
pc
pc
pc
pc
pc
XE
XE
XE
XE
XE
XE
XE
XE
XE
XE
XE
XE
XE
XE
XE
XE
XE
oS
oS
oS
oS
oS
oS
oS
oS
oS
oS
"}
(12,1,1) = {"
oS
oS
oS
oS
oS
oS
oS
oS
oS
oS
XE
lJ
lJ
lJ
lJ
lJ
lJ
hM
lJ
lJ
lJ
lJ
lJ
lJ
lJ
hM
lJ
lJ
lJ
lJ
lJ
lJ
lJ
lJ
hM
lJ
lJ
lJ
lJ
lJ
lJ
XE
oS
oS
oS
oS
oS
oS
oS
oS
oS
oS
"}
(13,1,1) = {"
oS
oS
oS
oS
oS
oS
oS
oS
oS
oS
XE
lJ
XE
XE
XE
XE
XE
XE
XE
XE
sA
sA
sA
sA
sA
XE
XE
XE
XE
XE
XE
XE
XE
XE
XE
XE
XE
XE
XE
XE
lJ
XE
oS
oS
oS
oS
oS
oS
oS
oS
oS
oS
"}
(14,1,1) = {"
oS
oS
oS
oS
oS
oS
oS
oS
oS
oS
XE
lJ
XE
wP
wP
wP
CW
CW
rn
CW
CW
CW
CW
CW
CW
qV
sA
ln
fS
fS
sY
fS
fS
fS
fS
sY
fS
fS
pt
XE
lJ
XE
oS
oS
oS
oS
oS
oS
oS
oS
oS
oS
"}
(15,1,1) = {"
oS
oS
oS
oS
oS
oS
oS
oS
oS
oS
XE
lJ
XE
wP
xk
GG
CW
CW
XE
CW
CW
CW
CW
CW
CW
CW
sA
qA
En
ZD
lP
Xm
NY
lP
LX
cb
lP
dh
BY
XE
lJ
XE
oS
oS
oS
oS
oS
oS
oS
oS
oS
oS
"}
(16,1,1) = {"
oS
oS
oS
oS
oS
oS
oS
oS
oS
oS
XE
lJ
XE
XE
XE
XE
fX
oi
XE
CW
CW
CW
CW
CW
CW
CW
sA
qA
lP
nO
gl
cH
lP
lP
Qn
sT
Lz
dh
BY
XE
lJ
XE
oS
oS
oS
oS
oS
oS
oS
oS
oS
oS
"}
(17,1,1) = {"
oS
oS
oS
oS
oS
oS
oS
oS
oS
oS
XE
lJ
XE
fJ
dz
ii
CW
oC
XE
CW
CW
CW
CW
CW
CW
CW
sA
qA
LK
lP
lm
pr
lP
lP
EO
CN
lP
UN
Nj
XE
lJ
XE
oS
oS
oS
oS
oS
oS
oS
oS
oS
oS
"}
(18,1,1) = {"
oS
oS
oS
oS
oS
oS
oS
oS
oS
oS
XE
pk
XE
ps
Ny
sO
sV
ZI
XE
CW
xX
CW
CW
CW
CW
CW
sA
qA
Hn
lP
lm
JU
lP
lP
Yn
CN
lP
kf
BY
XE
Am
XE
oS
oS
oS
oS
oS
oS
oS
oS
oS
oS
"}
(19,1,1) = {"
oS
oS
oS
oS
oS
oS
oS
oS
oS
oS
XE
XE
XE
XE
kx
XE
pc
XE
XE
XE
XE
XE
XE
sA
sA
sA
XE
qA
ys
lP
lm
aj
lP
lP
nC
CN
lP
kf
BY
XE
lJ
XE
oS
oS
oS
oS
oS
oS
oS
oS
oS
oS
"}
(20,1,1) = {"
oS
oS
oS
oS
oS
oS
oS
oS
oS
oS
Hp
oS
oS
oS
oS
oS
oS
oS
XE
XR
Ba
XR
XE
nz
CW
CW
sA
qA
rb
lP
iS
XE
lP
Cq
XE
YT
CX
Ci
BY
XE
lJ
XE
oS
oS
oS
oS
oS
oS
oS
oS
oS
oS
"}
(21,1,1) = {"
oS
oS
oS
oS
oS
oS
oS
oS
oS
oS
Hp
oS
oS
oS
oS
oS
oS
oS
pc
CW
CW
CW
pc
CW
CW
CW
sA
qA
Dt
lP
lm
BG
lP
lP
BG
lm
lP
lP
BY
XE
lJ
XE
oS
oS
oS
oS
oS
oS
oS
oS
oS
oS
"}
(22,1,1) = {"
oS
oS
oS
oS
oS
oS
oS
oS
oS
oS
Hp
oS
oS
oS
oS
oS
oS
oS
pc
CW
CW
CW
sA
CW
CW
CW
sA
qA
QU
lP
lm
yy
lP
lP
yy
lm
lP
lP
Nj
XE
lJ
XE
oS
oS
oS
oS
oS
oS
oS
oS
oS
oS
"}
(23,1,1) = {"
oS
oS
oS
oS
oS
oS
oS
oS
oS
oS
Hp
oS
oS
oS
oS
oS
oS
oS
pc
CW
CW
CW
sA
CW
CW
CW
sA
qA
VG
nO
iY
Lq
lP
lP
wP
gs
Lz
lP
BY
XE
lJ
XE
oS
oS
oS
oS
oS
oS
oS
oS
oS
oS
"}
(24,1,1) = {"
oS
oS
oS
oS
oS
oS
oS
oS
oS
oS
Hp
oS
Yy
Yy
Yy
Yy
Yy
oS
pc
CW
CW
CW
sA
CW
CW
CW
sA
qA
lP
lP
lm
qk
lP
lP
qk
lm
lP
lP
BY
XE
lJ
XE
oS
oS
oS
oS
oS
oS
oS
oS
oS
oS
"}
(25,1,1) = {"
oS
oS
oS
oS
oS
oS
oS
oS
oS
oS
Hp
oS
Yy
Yy
Yy
Yy
Yy
oS
pc
CW
CW
CW
pc
CW
CW
CW
sA
jr
uF
uF
uk
uF
uF
uF
uF
uk
uF
uF
zG
XE
lJ
XE
oS
oS
oS
oS
oS
oS
oS
oS
oS
oS
"}
(26,1,1) = {"
oS
oS
oS
oS
oS
oS
oS
oS
oS
oS
Hp
oS
Yy
Yy
Yy
Yy
Yy
oS
XE
Cu
QJ
Cu
XE
nz
CW
CW
sA
NY
Cu
qW
jd
CW
CW
CW
CW
SQ
GP
Cu
Uf
XE
lJ
XE
oS
oS
oS
oS
oS
oS
oS
oS
oS
oS
"}
(27,1,1) = {"
oS
oS
oS
oS
oS
oS
oS
oS
oS
oS
XE
XE
XE
pc
pc
pc
pc
XE
XE
XE
XE
XE
XE
sA
sA
sA
XE
XE
XE
XE
sA
sA
sA
sA
sA
sA
XE
XE
XE
XE
Am
XE
oS
oS
oS
oS
oS
oS
oS
oS
oS
oS
"}
(28,1,1) = {"
oS
oS
oS
oS
oS
oS
oS
oS
oS
oS
XE
lJ
XE
CW
CW
CW
CW
CW
sA
CW
qV
CW
CW
CW
CW
CW
bU
Gy
XR
XR
CW
CW
CW
CW
CW
CW
XR
XR
XR
sA
lJ
XE
oS
oS
oS
oS
oS
oS
oS
oS
oS
oS
"}
(29,1,1) = {"
oS
oS
oS
oS
oS
oS
oS
oS
oS
oS
XE
lJ
XE
CW
CW
CW
CW
CW
sA
CW
CW
CW
CW
CW
CW
CW
sA
Pc
yE
yE
yE
yE
yE
yE
yE
yE
yE
yE
yE
sA
lJ
XE
oS
oS
oS
oS
oS
oS
oS
oS
oS
oS
"}
(30,1,1) = {"
oS
oS
oS
oS
oS
oS
oS
oS
oS
oS
XE
lJ
XE
CW
CW
CW
CW
CW
sA
CW
CW
CW
CW
CW
CW
CW
sA
Pc
yE
mC
Cu
Cu
Cu
Cu
Cu
Cu
Cu
Cu
Cu
sA
lJ
XE
oS
oS
oS
oS
oS
oS
oS
oS
oS
oS
"}
(31,1,1) = {"
oS
oS
oS
oS
oS
oS
oS
oS
oS
oS
XE
lJ
XE
CW
CW
CW
CW
CW
sA
CW
CW
CW
CW
CW
CW
CW
sA
Pc
yE
xD
Gn
Gn
Gn
Gn
Gn
Gn
Gn
Gn
Gn
XE
Vm
XE
oS
oS
oS
oS
oS
oS
oS
oS
oS
oS
"}
(32,1,1) = {"
oS
oS
oS
oS
oS
oS
oS
oS
oS
oS
XE
lJ
XE
nz
CW
CW
CW
oI
XE
CW
CW
CW
CW
CW
CW
CW
sA
Pc
yE
xD
Gn
wP
wP
wP
wP
wP
wP
wP
wP
wP
wP
XE
oS
oS
oS
oS
oS
oS
oS
oS
oS
oS
"}
(33,1,1) = {"
oS
oS
oS
oS
oS
oS
oS
oS
oS
oS
XE
lJ
XE
CW
CW
CW
CW
CW
XE
CW
CW
CW
CW
CW
CW
CW
sA
Pc
yE
xD
Gn
wP
wP
wP
wP
wP
wP
wP
wP
wP
wP
XE
oS
oS
oS
oS
oS
oS
oS
oS
oS
oS
"}
(34,1,1) = {"
oS
oS
oS
oS
oS
oS
oS
oS
oS
oS
XE
lJ
XE
CW
CW
CW
CW
CW
XE
CW
xX
CW
CW
CW
xX
CW
sA
Pc
yE
xD
Gn
wP
wP
wP
wP
wP
wP
wP
wP
wP
wP
XE
oS
oS
oS
oS
oS
oS
oS
oS
oS
oS
"}
(35,1,1) = {"
oS
oS
oS
oS
oS
oS
oS
oS
oS
oS
XE
pk
XE
CW
CW
CW
CW
CW
XE
XE
XE
sA
sA
sA
XE
XE
XE
NY
jW
FE
Gn
wP
wP
wP
wP
wP
wP
wP
wP
wP
es
XE
oS
oS
oS
oS
oS
oS
oS
oS
oS
oS
"}
(36,1,1) = {"
oS
oS
oS
oS
oS
oS
oS
oS
oS
oS
XE
lJ
XE
CW
CW
CW
CW
CW
XE
CW
qV
CW
CW
CW
qV
CW
XE
wP
wP
wP
Gn
wP
wP
wP
wP
wP
wP
wP
wP
wP
wP
XE
oS
oS
oS
oS
oS
oS
oS
oS
oS
oS
"}
(37,1,1) = {"
oS
oS
oS
oS
oS
oS
oS
oS
oS
oS
XE
lJ
XE
nz
CW
CW
CW
oI
XE
CW
CW
CW
CW
CW
CW
CW
XE
wP
wP
wP
Gn
wP
wP
wP
wP
wP
wP
wP
wP
wP
wP
XE
oS
oS
oS
oS
oS
oS
oS
oS
oS
oS
"}
(38,1,1) = {"
oS
oS
oS
oS
oS
oS
oS
oS
oS
oS
XE
lJ
XE
CW
CW
CW
CW
CW
XE
CW
CW
CW
CW
CW
CW
CW
XE
wP
wP
wP
Gn
wP
wP
wP
wP
wP
wP
wP
wP
wP
wP
XE
oS
oS
oS
oS
oS
oS
oS
oS
oS
oS
"}
(39,1,1) = {"
oS
oS
oS
oS
oS
oS
oS
oS
oS
oS
XE
lJ
XE
CW
CW
CW
CW
CW
XE
CW
CW
CW
CW
CW
CW
CW
XE
wP
Xw
wP
Gn
wP
wP
wP
wP
wP
wP
wP
wP
wP
wP
XE
oS
oS
oS
oS
oS
oS
oS
oS
oS
oS
"}
(40,1,1) = {"
oS
oS
oS
oS
oS
oS
oS
oS
oS
oS
XE
lJ
XE
XE
XE
XE
XE
XE
XE
XE
sA
sA
sA
sA
sA
XE
XE
XE
XE
XE
XE
wP
wP
wP
wP
wP
wP
wP
wP
wP
wP
XE
oS
oS
oS
oS
oS
oS
oS
oS
oS
oS
"}
(41,1,1) = {"
oS
oS
oS
oS
oS
oS
oS
oS
oS
oS
XE
lJ
lJ
lJ
lJ
lJ
lJ
un
lJ
lJ
lJ
lJ
lJ
lJ
lJ
un
lJ
lJ
lJ
lJ
fU
wP
wP
wP
xk
wP
wP
wP
wP
wP
wP
XE
oS
oS
oS
oS
oS
oS
oS
oS
oS
oS
"}
(42,1,1) = {"
oS
oS
oS
oS
oS
oS
oS
oS
oS
oS
XE
XE
XE
XE
XE
XE
XE
XE
XE
XE
XE
XE
XE
XE
XE
XE
XE
XE
XE
XE
XE
XE
XE
XE
XE
XE
XE
XE
XE
XE
XE
XE
oS
oS
oS
oS
oS
oS
oS
oS
oS
oS
"}
(43,1,1) = {"
oS
oS
oS
oS
oS
oS
oS
oS
oS
oS
oS
oS
oS
oS
oS
oS
oS
oS
oS
oS
oS
oS
oS
oS
oS
oS
oS
oS
oS
oS
oS
oS
oS
oS
oS
oS
oS
oS
oS
oS
oS
oS
oS
oS
oS
oS
oS
oS
oS
oS
oS
oS
"}
(44,1,1) = {"
oS
oS
oS
oS
oS
oS
oS
oS
oS
oS
oS
oS
oS
oS
oS
oS
oS
oS
oS
oS
oS
oS
oS
oS
oS
oS
oS
oS
oS
oS
oS
oS
oS
oS
oS
oS
oS
oS
oS
oS
oS
oS
oS
oS
oS
oS
oS
oS
oS
oS
oS
oS
"}
(45,1,1) = {"
oS
oS
oS
oS
oS
oS
oS
oS
oS
oS
oS
oS
oS
oS
oS
oS
oS
oS
oS
oS
oS
oS
oS
oS
oS
oS
oS
oS
oS
oS
oS
oS
oS
oS
oS
oS
oS
oS
oS
oS
oS
oS
oS
oS
oS
oS
oS
oS
oS
oS
oS
oS
"}
(46,1,1) = {"
oS
oS
oS
oS
oS
oS
oS
oS
oS
oS
oS
oS
oS
oS
oS
oS
oS
oS
oS
oS
oS
oS
oS
oS
oS
oS
oS
oS
oS
oS
oS
oS
oS
oS
oS
oS
oS
oS
oS
oS
oS
oS
oS
oS
oS
oS
oS
oS
oS
oS
oS
oS
"}
(47,1,1) = {"
oS
oS
oS
oS
oS
oS
oS
oS
oS
oS
oS
oS
oS
oS
oS
oS
oS
oS
oS
oS
oS
oS
oS
oS
oS
oS
oS
oS
oS
oS
oS
oS
oS
oS
oS
oS
oS
oS
oS
oS
oS
oS
oS
oS
oS
oS
oS
oS
oS
oS
oS
oS
"}
(48,1,1) = {"
oS
oS
oS
oS
oS
oS
oS
oS
oS
oS
oS
oS
oS
oS
oS
oS
oS
oS
oS
oS
oS
oS
oS
oS
oS
oS
oS
oS
oS
oS
oS
oS
oS
oS
oS
oS
oS
oS
oS
oS
oS
oS
oS
oS
oS
oS
oS
oS
oS
oS
oS
oS
"}
(49,1,1) = {"
oS
oS
oS
oS
oS
oS
oS
oS
oS
oS
oS
oS
oS
oS
oS
oS
oS
oS
oS
oS
oS
oS
oS
oS
oS
oS
oS
oS
oS
oS
oS
oS
oS
oS
oS
oS
oS
oS
oS
oS
oS
oS
oS
oS
oS
oS
oS
oS
oS
oS
oS
oS
"}
(50,1,1) = {"
oS
oS
oS
oS
oS
oS
oS
oS
oS
oS
oS
oS
oS
oS
oS
oS
oS
oS
oS
oS
oS
oS
oS
oS
oS
oS
oS
oS
oS
oS
oS
oS
oS
oS
oS
oS
oS
oS
oS
oS
oS
oS
oS
oS
oS
oS
oS
oS
oS
oS
oS
oS
"}
(51,1,1) = {"
oS
oS
oS
oS
oS
oS
oS
oS
oS
oS
oS
oS
oS
oS
oS
oS
oS
oS
oS
oS
oS
oS
oS
oS
oS
oS
oS
oS
oS
oS
oS
oS
oS
oS
oS
oS
oS
oS
oS
oS
oS
oS
oS
oS
oS
oS
oS
oS
oS
oS
oS
oS
"}
(52,1,1) = {"
oS
oS
oS
oS
oS
oS
oS
oS
oS
oS
oS
oS
oS
oS
oS
oS
oS
oS
oS
oS
oS
oS
oS
oS
oS
oS
oS
oS
oS
oS
oS
oS
oS
oS
oS
oS
oS
oS
oS
oS
oS
oS
oS
oS
oS
oS
oS
oS
oS
oS
oS
oS
"}
